file_name	common_name	order
Galeopterus_variegatus	Sunda-Flying-Lemur	DERMOPTERA
Hyaena_hyaena	Striped-Hyena	CARNIVORA
Lepus_americanus	Snowshoe-Hare	LAGOMORPHA
Panthera_pardus	Leopard	CARNIVORA
Pantholops_hodgsonii	Chiru	CETARTIODACTYLA
Dolichotis_patagonum	Patagonian-Mara	RODENTIA
Oryctolagus_cuniculus	Rabbit	LAGOMORPHA
Callithrix_jacchus	White-tufted-ear-Marmoset	PRIMATES
Mellivora_capensis	Honey-Badger	CARNIVORA
Microcebus_murinus	Gray-Mouse-Lemur	PRIMATES
Papio_anubis	Olive-Baboon	PRIMATES
Procavia_capensis	South-African-Rock-Hyrax	HYRACOIDEA
Equus_caballus	Horse	PERISSODACTYLA
Sus_scrofa	Pig	CETARTIODACTYLA
Moschus_moschiferus	Siberian-Musk-Deer	CETARTIODACTYLA
Puma_concolor	Puma	CARNIVORA
Pongo_abelii	Sumatran-Orangutan	PRIMATES
Heterohyrax_brucei	African-Yellow-spotted-Rock-Hyrax	HYRACOIDEA
Sigmodon_hispidus	Hispid-Cotton-Rat	RODENTIA
Ctenomys_sociabilis	Social-Tuco-tuco	RODENTIA
Spermophilus_dauricus	Daurian-Ground-Squirrel	RODENTIA
Piliocolobus_tephrosceles	Ugandan-Red-Colobus	PRIMATES
Tonatia_saurophila	Stripe-headed-Round-eared-Bat	CHIROPTERA
Ammotragus_lervia	Aoudad	CETARTIODACTYLA
Crocidura_indochinensis	Indochinese-Shrew	EULIPOTYPHLA
Hipposideros_galeritus	Cantors-Leaf-nosed-Bat	CHIROPTERA
Dicerorhinus_sumatrensis	Sumatran-Rhinoceros	PERISSODACTYLA
Manis_pentadactyla	Chinese-Pangolin	PHOLIDOTA
Miniopterus_schreibersii	Common-Bent-wing-Bat	CHIROPTERA
Cebus_albifrons	White-fronted-Capuchin	PRIMATES
Bos_mutus	Wild-Yak	CETARTIODACTYLA
Nycticebus_coucang	Sunda-Slow-Loris	PRIMATES
Myrmecophaga_tridactyla	Giant-Anteater	PILOSA
Macaca_nemestrina	Pig-tailed-Macaque	PRIMATES
Mus_caroli	Ryukyu-Mouse	RODENTIA
Ochotona_princeps	American-Pika	LAGOMORPHA
Tursiops_truncatus	Bottlenose-Dolphin	CETARTIODACTYLA
Zalophus_californianus	California-Sea-Lion	CARNIVORA
Nannospalax_galili	Upper-Galilee-Mountains-Blind-Mole-Rat	RODENTIA
Ailuropoda_melanoleuca	Giant-Panda	CARNIVORA
Equus_przewalskii	Przewalskis-Horse	PERISSODACTYLA
Panthera_tigris	Amur-Tiger	CARNIVORA
Saimiri_boliviensis	Bolivian-Squirrel-Monkey	PRIMATES
Echinops_telfairi	Small-Madagascar-Hedgehog	AFROSORICIDA
Onychomys_torridus	Scorpion-Mouse	RODENTIA
Ellobius_lutescens	Transcaucasian-Mole-Vole	RODENTIA
Peromyscus_maniculatus	Prairie-Deer-Mouse	RODENTIA
Condylura_cristata	Star-nosed-Mole	EULIPOTYPHLA
Camelus_ferus	Wild-Bactrian-Camel	CETARTIODACTYLA
Mustela_putorius	Domestic-Ferret	CARNIVORA
Pteronura_brasiliensis	Giant-Otter	CARNIVORA
Cheirogaleus_medius	Fat-tailed-Dwarf-Lemur	PRIMATES
Desmodus_rotundus	Common-Vampire-Bat	CHIROPTERA
Capromys_pilorides	Desmarests-Hutia	RODENTIA
Ellobius_talpinus	Northern-Mole-Vole	RODENTIA
Balaenoptera_acutorostrata	Minke-Whale	CETARTIODACTYLA
Trichechus_manatus	Florida-Manatee	SIRENIA
Panthera_onca	Jaguar	CARNIVORA
Craseonycteris_thonglongyai	Bumblebee-Bat	CHIROPTERA
Cercocebus_atys	Sooty-Mangabey	PRIMATES
Cryptoprocta_ferox	Fossa	CARNIVORA
Nomascus_leucogenys	Northern-White-cheeked-Gibbon	PRIMATES
Indri_indri	Indri	PRIMATES
Graphiurus_murinus	Woodland-Doormouse	RODENTIA
Delphinapterus_leucas	Beluga-Whale	CETARTIODACTYLA
Eschrichtius_robustus	Grey-Whale	CETARTIODACTYLA
Bos_indicus	Zebu-Cattle	CETARTIODACTYLA
Hydrochoerus_hydrochaeris	Capybara	RODENTIA
Beatragus_hunteri	Hirola	CETARTIODACTYLA
Cricetulus_griseus	Chinese-Hamster	RODENTIA
Bos_taurus	Cattle	CETARTIODACTYLA
Diceros_bicornis	Black-Rhinocerous	PERISSODACTYLA
Antilocapra_americana	Pronghorn	CETARTIODACTYLA
Myocastor_coypus	Coypu	RODENTIA
Felis_nigripes	Black-footed-Cat	CARNIVORA
Alouatta_palliata	Mexican-Howler-Monkey	PRIMATES
Eptesicus_fuscus	Big-Brown-Bat	CHIROPTERA
Okapia_johnstoni	Okapi	CETARTIODACTYLA
Vulpes_lagopus	Arctic-Fox	CARNIVORA
Psammomys_obesus	Fat-Sand-Rat	RODENTIA
Hystrix_cristata	Northern-Crested-Porcupine	RODENTIA
Ceratotherium_simum	Southern-White-Rhinoceros	PERISSODACTYLA
Rhinopithecus_bieti	Black-Snub-nosed-Monkey	PRIMATES
Erinaceus_europaeus	Western-European-Hedgehog	EULIPOTYPHLA
Mirounga_angustirostris	Northern-Elephant-Seal	CARNIVORA
Tapirus_indicus	Malayan-Tapir	PERISSODACTYLA
Mandrillus_leucophaeus	Drill	PRIMATES
Cebus_capucinus	White-faced-Sapajou	PRIMATES
Macaca_mulatta	Rhesus-Monkey	PRIMATES
Mormoops_blainvillei	Ghost-faced-Bat	CHIROPTERA
Ondatra_zibethicus	Muskrat	RODENTIA
Glis_glis	Edible-Dormouse	RODENTIA
Artibeus_jamaicensis	Jamacian-Fruit-eating-Bat	CHIROPTERA
Cavia_aperea	Brazilian-Guinea-Pig	RODENTIA
Aplodontia_rufa	Mountain-Beaver	RODENTIA
Mus_spretus	Western-Wild-Mouse	RODENTIA
Eidolon_helvum	Straw-colored-Fruit-Bat	CHIROPTERA
Aotus_nancymaae	Mas-Night-Monkey	PRIMATES
Ziphius_cavirostris	Cuviers-Beaked-Whale	CETARTIODACTYLA
Muscardinus_avellanarius	Hazel-Dormouse	RODENTIA
Ovis_aries	Sheep	CETARTIODACTYLA
Marmota_marmota	Alpine-Marmot	RODENTIA
Allactaga_bullata	Gobi-Jerboa	RODENTIA
Heterocephalus_glaber	Naked-Mole-rat	RODENTIA
Suricata_suricatta	Meerkat	CARNIVORA
Spilogale_gracilis	Western-Spotted-Skunk	CARNIVORA
Tadarida_brasiliensis	Mexican-Free-tailed-Bat	CHIROPTERA
Megaderma_lyra	Greater-False-Vampire-Bat	CHIROPTERA
Platanista_gangetica	Indus-River-Dolphin	CETARTIODACTYLA
Orycteropus_afer	Aardvark	TUBULIDENTATA
Microgale_talazaci	Talazacs-Shrew-Tenrec	AFROSORICIDA
Ictidomys_tridecemlineatus	Thirteen-lined-Ground-Squirrel	RODENTIA
Rhinolophus_sinicus	Chinese-Rufous-Horseshoe-Bat	CHIROPTERA
Pithecia_pithecia	White-faced-Saki	PRIMATES
Petromus_typicus	Dassie-Rat	RODENTIA
Cuniculus_paca	Lowland-Paca	RODENTIA
Enhydra_lutris	Sea-Otter	CARNIVORA
Mus_musculus	House-Mouse	RODENTIA
Hipposideros_armiger	Great-Roundleaf-Bat	CHIROPTERA
Camelus_dromedarius	Arabian-Camel	CETARTIODACTYLA
Choloepus_hoffmanni	Hoffmanns-Two-fingered-Sloth	PILOSA
Chaetophractus_vellerosus	Screaming-Hairy-Armadillo	CINGULATA
Loxodonta_africana	African-Savanna-Elephant	PROBOSCIDEA
Colobus_angolensis	Angolan-Colobus	PRIMATES
Sorex_araneus	European-Shrew	EULIPOTYPHLA
Tupaia_chinensis	Northern-Tree-Shrew	SCANDENTIA
Jaculus_jaculus	Lesser-Egyptian-Jerboa	RODENTIA
Macaca_fascicularis	Crab-eating-Macaque	PRIMATES
Helogale_parvula	Dwarf-Mongoose	CARNIVORA
Eulemur_flavifrons	Sclaters-Lemur	PRIMATES
Microtus_ochrogaster	Prairie-Vole	RODENTIA
Mus_pahari	Shrew-Mouse	RODENTIA
Saguinus_imperator	Emperor-Tamarin	PRIMATES
Daubentonia_madagascariensis	Aye-aye	PRIMATES
Mesocricetus_auratus	Golden-Hamster	RODENTIA
Pan_paniscus	Pygmy-Chimpanzee	PRIMATES
Neophocaena_asiaeorientalis	Yangtze-Finless-Porpoise	CETARTIODACTYLA
Rattus_norvegicus	Norway-Rat	RODENTIA
Thryonomys_swinderianus	Greater-Cane-Rat	RODENTIA
Phocoena_phocoena	Harbor-Porpoise	CETARTIODACTYLA
Nasalis_larvatus	Proboscis-Monkey	PRIMATES
Tamandua_tetradactyla	Southern-Tamandua	PILOSA
Rhinopithecus_roxellana	Golden-Snub-nosed-Monkey	PRIMATES
Chrysochloris_asiatica	Cape-Golden-Mole	AFROSORICIDA
Miniopterus_natalensis	Bats	CHIROPTERA
Callicebus_donacophilus	White-eared-Titi	PRIMATES
Mirza_coquereli	Coquerels-Giant-Mouse-Lemur	PRIMATES
Noctilio_leporinus	Greater-Bulldog-Bat	CHIROPTERA
Bubalus_bubalis	Water-Buffalo	CETARTIODACTYLA
Inia_geoffrensis	Amazon-River-Dolphin	CETARTIODACTYLA
Xerus_inauris	Cape-Ground-Squirrel	RODENTIA
Tolypeutes_matacus	Southern-Three-banded-Armadillo	CINGULATA
Propithecus_coquereli	Coquerels-Sifaka	PRIMATES
Tupaia_tana	Large-Treeshrew	SCANDENTIA
Solenodon_paradoxus	Hispaniolan-Solenodon	EULIPOTYPHLA
Erythrocebus_patas	Patas-Monkey	PRIMATES
Eulemur_fulvus	Common-Brown-Lemur	PRIMATES
Orcinus_orca	Killer-Whale	CETARTIODACTYLA
Zapus_hudsonius	Meadow-Jumping-Mouse	RODENTIA
Camelus_bactrianus	Bactrian-Camel	CETARTIODACTYLA
Myotis_lucifugus	Little-Brown-Bat	CHIROPTERA
Mesoplodon_bidens	Sowerbys-Beaked-Whale	CETARTIODACTYLA
Perognathus_longimembris	Pacific-Pocket-Mouse	RODENTIA
Myotis_brandtii	Brandts-Bat	CHIROPTERA
Chlorocebus_sabaeus	Green-Monkey	PRIMATES
Chinchilla_lanigera	Long-tailed-Chinchilla	RODENTIA
Canis_lupus_familiaris	Domestic-Dog	CARNIVORA
Dinomys_branickii	Pacarana	RODENTIA
Pteronotus_parnellii	Parnells-Mustached-Bat	CHIROPTERA
Kogia_breviceps	Pygmy-Sperm-Whale	CETARTIODACTYLA
Ovis_canadensis	Peninsular-Bighorn-Sheep	CETARTIODACTYLA
Pygathrix_nemaeus	Red-shanked-Douc	PRIMATES
Cricetomys_gambianus	Gambian-Pouched-Rat	RODENTIA
Ursus_maritimus	Polar-Bear	CARNIVORA
Odocoileus_virginianus	White-tailed-Deer	CETARTIODACTYLA
Macroglossus_sobrinus	Long-tongued-Fruit-Bat	CHIROPTERA
Lipotes_vexillifer	Yangtze-River-Dolphin	CETARTIODACTYLA
Cavia_tschudii	Montane-Guinea-Pig	RODENTIA
Saiga_tatarica	Russian-Saiga	CETARTIODACTYLA
Choloepus_didactylus	Linnaeuss-Two-Toed-Sloth	PILOSA
Equus_asinus	Ass	PERISSODACTYLA
Lycaon_pictus	African-Hunting-Dog	CARNIVORA
Tragulus_javanicus	Java-Lesser-Chevrotain	CETARTIODACTYLA
Rangifer_tarandus	Siberian-Reindeer	CETARTIODACTYLA
Eubalaena_japonica	North-Pacific-Right-Whale	CETARTIODACTYLA
Cavia_porcellus	Domestic-Guinea-Pig	RODENTIA
Dasyprocta_punctata	Central-American-Agouti	RODENTIA
Semnopithecus_entellus	Northern-Plains-Gray-Langur	PRIMATES
Pteropus_vampyrus	Large-Flying-Fox	CHIROPTERA
Dasypus_novemcinctus	Nine-banded-Armadillo	CINGULATA
Paradoxurus_hermaphroditus	Asian-Palm-Civet	CARNIVORA
Murina_feae	Ashy-gray-Tube-nosed-Bat	CHIROPTERA
Myotis_myotis	Greater-Mouse-eared-Bat	CHIROPTERA
Anoura_caudifer	Tailed-Tailless-Bat	CHIROPTERA
Rousettus_aegyptiacus	Egyptian-Fruit-Bat	CHIROPTERA
Manis_javanica	Malayan-Pangolin	PHOLIDOTA
Tapirus_terrestris	South-American-Tapir	PERISSODACTYLA
Neomonachus_schauinslandi	Hawaiian-Monk-Seal	CARNIVORA
Micronycteris_hirsuta	Hairy-Big-eared-Bat	CHIROPTERA
Acinonyx_jubatus	Cheetah	CARNIVORA
Uropsilus_gracilis	Gracile-Shrew-like-Mole	EULIPOTYPHLA
Monodon_monoceros	Narwhal	CETARTIODACTYLA
Meriones_unguiculatus	Mongolian-Jird	RODENTIA
Balaenoptera_bonaerensis	Antarctic-Minke-Whale	CETARTIODACTYLA
Otolemur_garnettii	Small-eared-Galago	PRIMATES
Scalopus_aquaticus	Eastern-Mole	EULIPOTYPHLA
Cercopithecus_neglectus	De-Brazzas-Monkey	PRIMATES
Ctenodactylus_gundi	Common-Gundi	RODENTIA
Capra_hircus	Goat	CETARTIODACTYLA
Pan_troglodytes	Chimpanzee	PRIMATES
Catagonus_wagneri	Chacoan-Peccary	CETARTIODACTYLA
Dipodomys_stephensi	Stephens-Kangaroo-Rat	RODENTIA
Carollia_perspicillata	Sebas-Short-tailed-Bat	CHIROPTERA
Hippopotamus_amphibius	Hippopotamus	CETARTIODACTYLA
Pteropus_alecto	Black-Flying-Fox	CHIROPTERA
Elaphurus_davidianus	Pere-Davids-Deer	CETARTIODACTYLA
Fukomys_damarensis	Damara-Mole-rat	RODENTIA
Myotis_davidii	Bats	CHIROPTERA
Lasiurus_borealis	Eastern-Red-Bat	CHIROPTERA
Ceratotherium_simum_cottoni	Northern-White-Rhino	PERISSODACTYLA
Lemur_catta	Ring-Tailed-Lemur	PRIMATES
Odobenus_rosmarus	Pacific-Walrus	CARNIVORA
Hemitragus_hylocrius	Nilgiri-Tahr	CETARTIODACTYLA
Ailurus_fulgens	Lesser-Panda	CARNIVORA
Mungos_mungo	South-African-Banded-Mongoose	CARNIVORA
Elephantulus_edwardii	Cape-Elephant-Shrew	MACROSCELIDEA
Octodon_degus	Degu	RODENTIA
Canis_lupus	Domestic-Dog	CARNIVORA
Capra_aegagrus	Wild-Goat	CETARTIODACTYLA
Gorilla_gorilla	Western-Lowland-Gorilla	PRIMATES
Ateles_geoffroyi	Geoffroys-Spider-Monkey	PRIMATES
Castor_canadensis	North-American-Beaver	RODENTIA
Bison_bison	American-Bison	CETARTIODACTYLA
Leptonychotes_weddellii	Weddell-Seal	CARNIVORA
Dipodomys_ordii	Ords-Kangaroo-Rat	RODENTIA
Pipistrellus_pipistrellus	Common-Pipistrelle	CHIROPTERA
Acomys_cahirinus	Cairo-Spiny-Mouse	RODENTIA
Felis_catus	Domestic-Cat	CARNIVORA
Vicugna_pacos	Alpaca	CETARTIODACTYLA
Giraffa_tippelskirchi	Giraffe	CETARTIODACTYLA
Homo_sapiens	human	PRIMATES
